1111111111111111111
1000000000000000001
1000000E000E0000001
10P0000000000000001
10000000000P0000001
1000000C000C0000001
1111111111111111110
