1111111111111111111
10000000000000C0001
1011100000000000001
1000000P00000000001
1000000001111110001
1000000000CC00000E1
1111111111111111111
