1111111111111111111
10111000000000001E1
1000000111000000101
1P00000000001100001
1000000000000000001
1000000011100000001
1111111111111111111
