1111111111111111111
10000011111000C0001
1000000000000000001
1000000000000000001
10CC000P00000000001
1000001111111111001
10011111100000000E1
1000000000000000001
1000000000000000001
1000000000000000001
1111111111111111111
